

111111111111111
111111000000001
111000000011111
111000000011111
111000000011111
111011111011111
11101000S011111000011111
111010000011111111111111
111010000011111
11111111111111111111
