111111111
111100001
100000001
100000001
100000001
101111101
101000N01
101000001
101000001
111111111