111111111
111100001
100000001
100000001
100000001
101111101
101000001
1010E0001
101000001
111111111