NO ./fish4.xpm
SO ./glace3.xpm
WE ./pingouin.xpm
EA ./sol3.xpm
F 220,100,0
C 225,30,0

111111111111111111111111111111111
111111111000000000110000000000001
1111111110110000011100000100N0001
111111111001000000000000001000001
111111111011000001110000000000001
100000000011000001110111111111111
111101111111110111000000100011111
111101111111110111010100000011111
110000001101010111000000100011111
100000000000000011000000100011111
100000000000000011010100100011111
110000011101010111110111100011111
111101111111010111011110100011111
111111111111111111111111111111111
