NO ./textures/fish4.xpm
SO ./textures/glace3.xpm
WE ./textures/pingouin.xpm
EA ./textures/sol3.xpm
F 220,100,0
C 225,30,0

111111111111111111111111111111111
111111111000000000110000000000001
111111111011000001110000000000001
111111111001000000000000000000001
111111111011000001110000000000001
100000000011000001110111111111111
1111011111111101110000001000111111
11110111111111011101010000S00000001
11000000110101011100000010001111111111111
100000000000000011000000100011111
100000000000000011010100100011111
110000011101010111110111100011111
111101111111010111011110100011111
111111111111111111111111111111111
