NO ./textures/bookshelf.xpm
SO ./textures/eagle.xpm
WE ./textures/greystone.xpmm
EA ./textures/red.xpm

C 255,200,50
F 10,10,10

11111111111111111
10000000000000001
10000000000000001
10000000000000001
10000000000000001
10000000000000001
100000000S0000001
10000000000000001
10000000000000001
10000000000000001
10000000000000001
10000000000000001
11111111111111111